16 = width
16 = height
1111111111111111
1000000000011001
1001111110011001
1001111110011001
100*0*0110011001
1000110110011001
10*011*****11001
1000111x11111001
10*0111111111001
1000001110000111
1111110001111011
1111111111111011
1000001100000101
1111101100110101
1000000000110101
1111111111111111
