16 = width
16 = height
1111111111111111
1**************1
1*111111111111*1
1*1**********1*1
1*1*11111111*1*1
1*1*1******1*1*1
1*1*1*1111*1*1*1
1*1*1*1**1*1*1*1
1*1*1*1****1*1*1
1*1*1*111111*1*1
1*1*1********1*1
1*1*1111111111*1
1*1************1
1*11111111111111
1*************x1
1111111111111111